111111111111111111111111
1101101110111101101110E1
100000000000000000000001
100100111001001100100CC1
1P0000000000000000000CC1
111111111111111111111111
