111111111
100100001
110000001
100000011
111111111
