1111111111
10000000P1
1101111111
1111111111
