11111111
10P00001
11111111
11111111
11111111
11111111
11111111
11111111
11111111
11111111
11111111
11111111
