111111
1E00C1
100001
10P001
111111
