1111111
1E0E0E1
1000001
1E0P0E1
100E001
1E0E0E1
1111111
