111111111111
1P0000000001
111111111111
