111111
100001
1P0001
100001
111111
