1111111
10P0001
1000001
1111111
