111111
1P00C1
100C01
1C00C1
111111
