111111111111
100000000001
1P0000000001
111111111111
