1111111
1E0C0P1
1000001
1111111
