1111111111111
1000000000001
1000111110101
1010000000001
1000000000101
100000P000001
1111111111111
