111111111111
101110101101
100000000001
100000000001
1P0000000001
111111111111
