111111111111
101110101101
1T00000000C1
10000000CC01
1P00000000E1
111111111111
