11111111111
11010101011
10000000001
1P000000001
11111111111
