1111111111
1100000011
1000000001
1100000011
1100000011
1100000011
1000000001
11000P0011
1111111111
