11111111
10000001
10001001
1P000001
11111111
