1111111111
1000000001
1000111101
1P00000001
1111111111
